
NO ./textures/redbrick.xpm
SO ./textures/bluestone.xpm
WE ./textures/greystone.xpm
EA ./textures/wood.xpm

R 640 480

S ./textures/barrel.xpm
F 255,248,220
C 135,206,250

111111111111111111111111111111111111111111111111111111111
100000000000000000001111111111111111111111111110000000111
10000000000000000000001111111100000000000000000000000111
10001111111111111111111      10000000000000000000000111
10000000000000000000001111111111111111111111111111111111
100000000000000000000000000111
100000000011111111111111111111111111111111
10000000002200220000000000011111      111
10000000000000000000000000000111111111111
10000000011111111111111111111100000001111
100000000000000000000000000000000000000111
10000000000111111111100000000001111111111111111111111111111111
1000111111111111111111111000000000000000000000000000111
100000000000000000000000000111111111111111111111111111111
100000000000000000000000111111111111111111111111111000111
100000000000000111111111111111111111111111000000000000111
100000000000000111111111111111111111111111000000000000111
100000000000000000000011111111111111111111111111100000111
10000000000000000000000000011000000000000000000000000001
10000000000000000000000000011000000000000000000000000001
10000000000000000000000000011000000000000000000000000001
10000000000000000000000000011000000000000000000000000001
10000000000000000000000000010000000000000000000000000011
10000000000000000000000000010000000000000000000000000011
10000000000000000000000000010000000000000000000000000011
10000000000000000000000000011000000000000000000000000001
10000000000000000000000000000000000000000000000000000111
10000000000000000000N00000000000000000000000000000111111
10000000000000000111111000000000000000000000000001111111
10000000000000000000000000000000000000000000000000000111
10000000000000000000000000000000000000000000000000001111
100000000000001111111111111111111111111110000000000000111
100000000111111111111111111111111111000000000000000000111
111111111111111111111111111111111111111111111111111111111