R 1920 1080
NO ./textures/colorstone.xpm
SO ./textures/bluestone.xpm
WE ./textures/greystone.xpm
EA ./textures/wood.xpm

S ./textures/barrel.xpm
F 255,248,220
C 135,206,250

1111111111111111111111111
10000000001100000001    1111
1011000001110000002111111
100100000000000000000N001
1111111110110000011100001
1000000000110000011101111
1111011111111101110000001
1111011111111101110101001
1100000011010101110000001
1000200000000000110000001
1000000000000000110101001
1100000111010101111101101
1111011111110101110111101
1111111111111111111111111
